Size
20
20

Grid
19 19 19 19 19 19 19 19 19 19 19 19 19 19 19 19 19 19 19 19 
19 23 23 23 23 19 19 19 23 19 19 19 19 19 23 23 23 23 23 19 
5 3 3 3 3 3 3 3 3 3 3 3 3 3 3 3 3 3 5 19 
5 3 3 3 3 3 3 3 3 3 3 3 3 3 3 3 3 3 3 19 
5 3 3 3 3 19 19 19 19 3 19 19 19 19 3 3 3 3 3 19 
5 6 7 3 19 19 6 7 19 3 19 19 19 19 3 3 3 3 3 19 
19 19 3 3 19 19 19 19 19 3 5 5 5 19 19 19 3 3 19 19 
19 23 3 3 3 19 19 19 23 3 19 19 19 19 19 19 3 3 19 19 
19 23 3 3 3 3 3 3 3 3 19 19 19 19 3 3 3 3 23 19 
19 23 3 3 3 3 3 3 3 3 19 19 19 19 3 3 3 3 23 19 
19 5 3 3 3 19 19 19 3 3 19 6 7 19 3 3 3 3 23 19 
19 19 19 19 19 19 19 19 3 3 19 19 19 19 19 3 3 19 19 19 
19 19 19 19 19 23 23 19 3 3 3 3 3 3 3 3 3 19 19 19 
19 19 19 5 19 23 23 19 3 3 19 19 19 19 19 3 3 19 19 19 
19 19 19 19 19 19 19 19 3 3 19 19 6 7 19 3 3 3 19 19 
19 3 3 3 23 19 19 19 3 3 19 19 19 19 19 3 3 3 19 19 
19 3 3 3 3 3 3 3 3 3 3 3 3 23 3 3 3 3 19 19 
19 3 3 3 3 3 3 3 3 3 3 3 3 3 3 3 3 3 19 5 
19 3 3 3 3 19 19 19 19 19 19 19 19 19 19 3 3 5 5 5 
19 19 19 19 19 19 19 19 19 19 19 19 19 19 19 19 19 19 5 5 

Player Spawn
2
17

Enemy Spawns
1
2
1
3
1
4
2
4
3
4
3
3
4
3
4
2
3
2
2
2
2
3
4
4
14
2
14
3
14
4
14
5
15
5
15
4
16
4
17
4
17
5
18
5
16
5
18
4
18
3
17
3
17
2
16
2
15
2
15
3
16
3
17
14
17
15
17
16
17
17
16
18
16
17
16
16
16
15
15
18
15
17
14
8
14
9
15
8
14
10
17
10
17
9
15
9
15
10
16
10
16
9
17
8
16
8
4
7
4
8
4
9
3
9
2
9
2
8
3
8
3
7
2
7
2
10
3
10
4
10

Enemy Count
100

