Size
30
20

Grid
8 8 8 8 8 4 4 4 4 4 4 4 8 8 8 4 4 4 4 4 4 4 4 24 24 24 4 4 2 2 
8 8 8 8 8 4 8 8 8 8 8 4 8 8 8 4 4 8 14 8 4 4 4 24 18 24 4 2 2 2 
8 8 8 8 8 4 8 8 8 8 8 4 8 8 8 4 4 13 4 13 4 24 24 1 13 24 20 20 18 1 
8 8 8 8 8 4 8 8 8 8 8 4 8 8 8 4 4 13 4 13 3 24 18 1 8 9 14 14 8 1 
4 4 4 4 4 4 8 8 8 8 8 4 8 8 8 4 4 13 4 13 3 24 13 1 8 8 21 21 13 1 
8 8 8 8 8 2 8 8 8 8 2 4 8 8 8 4 4 8 14 8 3 24 11 8 8 21 21 9 12 21 
8 8 8 8 8 2 4 4 4 4 4 4 4 4 8 4 4 4 4 4 3 24 10 10 8 14 14 11 12 21 
2 2 24 24 24 4 4 4 4 4 4 4 4 4 8 8 8 4 4 4 3 24 24 20 13 21 21 8 12 21 
4 4 24 18 24 4 4 4 4 4 8 8 8 4 8 8 8 8 8 8 3 24 24 20 13 21 21 21 21 21 
4 4 24 13 24 4 4 1 1 1 4 4 4 2 8 22 22 22 22 8 3 24 24 24 11 9 21 18 21 8 
4 4 24 13 24 4 4 1 4 4 20 20 24 2 24 22 22 22 22 8 3 24 24 20 11 8 14 8 21 21 
4 2 2 13 1 1 4 1 4 24 20 9 9 2 18 22 22 22 22 8 3 24 24 20 13 21 21 21 21 8 
2 2 2 13 1 1 1 18 21 18 20 11 12 2 13 22 22 22 22 24 24 20 20 20 11 9 12 21 4 8 
4 2 2 13 4 1 1 11 9 8 9 10 10 14 10 14 14 14 14 14 14 14 14 14 8 10 12 21 21 8 
4 2 2 11 14 14 9 10 10 10 10 20 20 20 20 24 20 20 24 24 24 20 20 20 13 21 21 21 4 8 
22 4 4 13 4 4 13 4 4 4 4 20 20 20 4 4 20 20 4 4 24 4 4 20 13 21 4 4 4 8 
22 4 4 13 22 22 13 22 22 22 22 4 4 4 4 4 4 4 4 4 24 24 4 20 20 20 4 4 4 4 
4 22 4 13 4 4 13 4 22 22 22 4 4 8 14 14 14 8 4 24 24 24 4 20 20 20 4 4 4 4 
24 14 14 10 14 14 12 4 24 4 4 4 4 13 4 4 4 13 4 24 24 24 4 20 20 20 4 24 4 4 
21 21 24 24 24 24 24 24 24 4 2 2 4 13 4 4 4 13 4 24 24 24 24 24 24 4 24 24 24 4 

Player Spawn
28
3

Enemy Spawns
22
3
22
4
27
9
27
10
26
12
26
13
24
1
24
15
14
11
11
11
12
11
9
12
7
12
1
18
1
15
1
16
7
17
7
18
3
8
3
9
10
15
10
14
9
15
4
13
4
15
5
15
4
17
5
17
2
15
2
16
2
17

Enemy Count
100

