Size
30
30

Grid
24 24 24 24 24 24 24 24 4 4 33 33 33 33 33 33 33 33 33 33 33 33 33 33 33 33 33 33 33 33 
24 24 3 3 3 24 24 24 24 24 4 4 4 4 4 4 33 34 4 4 24 4 24 24 24 4 4 33 33 33 
24 24 3 3 3 3 6 7 24 24 4 24 24 24 24 4 4 4 24 24 24 24 24 24 24 24 4 4 33 33 
24 24 3 3 3 3 3 3 24 24 24 24 24 24 24 4 5 4 24 24 24 3 3 3 24 24 4 4 33 33 
24 24 24 24 3 3 3 3 3 3 3 3 3 3 24 24 4 24 24 3 3 3 3 3 3 24 24 24 4 33 
4 24 24 24 3 3 24 3 3 3 3 3 3 3 3 24 24 24 3 5 24 24 24 24 3 3 24 24 24 4 
33 4 24 24 24 3 24 3 3 24 24 3 3 3 3 3 3 3 3 3 24 24 3 3 3 3 3 24 24 4 
33 4 24 24 24 24 24 3 3 24 4 24 24 24 24 3 3 3 3 24 33 24 3 3 3 3 3 24 24 24 
33 24 24 3 24 24 24 3 3 24 24 33 33 24 24 3 3 3 24 33 33 33 24 3 3 3 4 3 3 24 
33 24 24 3 24 24 3 3 3 3 24 33 33 4 24 24 24 3 24 33 33 33 24 3 3 3 4 3 3 24 
4 24 24 3 3 3 3 24 3 3 24 24 33 4 4 24 24 3 3 3 24 24 24 3 3 24 4 3 3 24 
24 24 24 24 3 3 3 24 24 3 3 24 24 24 24 24 24 3 3 3 24 24 3 3 24 24 24 3 3 24 
24 24 3 24 3 4 24 24 4 3 3 3 3 3 3 3 3 3 3 3 24 24 3 4 24 24 24 3 3 24 
24 24 3 3 3 4 4 4 4 4 3 3 3 3 3 3 3 3 3 24 24 24 24 3 24 24 3 3 3 24 
24 24 33 33 3 4 4 4 24 4 3 24 24 24 3 3 3 3 24 24 4 24 24 3 24 24 3 3 3 24 
24 24 33 33 4 4 4 3 24 4 3 5 24 24 24 24 3 3 24 4 24 24 24 3 24 4 3 3 24 24 
24 24 33 33 24 24 4 3 24 3 24 4 4 4 4 24 3 3 24 24 24 24 3 3 24 24 3 3 24 4 
24 24 3 3 24 24 3 3 3 3 24 4 4 3 3 3 3 3 3 3 3 3 3 3 24 24 24 3 24 4 
24 24 24 24 24 3 3 3 3 3 24 4 4 3 3 3 3 3 3 3 3 3 5 3 24 24 24 24 33 4 
4 4 24 24 24 24 3 24 3 3 3 4 4 4 4 24 3 3 4 4 3 3 3 3 24 33 33 33 33 33 
33 4 4 4 24 24 3 24 3 24 3 3 24 24 4 24 3 3 4 33 33 3 3 3 24 24 33 33 33 33 
33 33 4 24 24 24 3 24 24 24 24 3 3 24 24 24 3 3 4 33 33 3 3 3 3 3 24 24 4 4 
33 33 4 24 24 3 3 24 24 4 24 24 3 3 3 3 3 3 24 24 24 3 3 3 24 24 24 24 24 4 
33 4 4 24 24 3 3 3 24 24 4 24 24 3 3 3 3 3 24 4 24 3 3 3 24 24 24 24 24 24 
33 4 24 24 3 3 3 3 3 24 4 4 24 24 24 24 24 4 24 24 24 24 3 3 3 3 3 24 24 4 
33 4 24 24 24 5 3 3 24 24 4 4 24 24 24 24 24 24 24 24 24 24 3 3 3 3 3 3 24 24 
33 33 4 24 24 3 3 5 3 24 4 4 4 24 4 4 4 4 4 4 4 24 24 3 6 7 3 24 24 4 
33 33 4 24 24 24 3 24 24 24 4 4 4 4 4 4 33 33 4 4 4 4 24 24 3 3 24 24 24 4 
33 33 4 4 4 24 24 24 4 4 4 33 33 33 4 4 33 33 33 33 4 4 4 24 24 24 24 4 4 4 
33 33 33 33 4 24 4 4 4 4 33 33 33 33 33 33 33 33 33 33 33 33 4 4 24 4 4 4 4 4 

Player Spawn
18
12

Enemy Spawns
2
1
3
1
3
2
4
2
4
1
2
2
5
2
5
5
5
4
4
4
11
4
12
4
13
4
13
5
12
5
11
5
4
10
4
11
4
12
4
13
2
12
2
13
3
13
6
25
6
26
6
24
7
24
7
23
6
23
6
22
5
22
5
23
26
25
26
24
25
24
24
24
24
25
25
25
27
16
27
15
26
15
26
14
27
14
27
8
28
8
28
9
27
9
21
3
21
4
22
4
23
4
23
3
22
3
11
16
11
17
12
17
12
16
13
16
11
18
7
13
7
14
7
15
7
16
16
23
17
23
17
22
16
22
15
22
15
23
21
17
21
18
20
18
20
17
8
6
8
7
8
8
7
8
7
7
7
6

Enemy Count
150

