Size
20
20

Grid
3 3 3 3 3 3 3 3 3 3 3 3 3 3 3 3 3 3 3 3 
3 3 3 3 3 3 3 3 3 3 3 3 3 3 3 3 3 3 3 3 
3 3 3 3 3 3 31 31 3 31 3 31 31 3 3 3 3 3 3 3 
3 3 3 3 31 31 3 3 3 3 3 3 3 31 31 31 3 3 3 3 
3 3 3 27 31 3 3 3 31 31 31 31 31 3 3 31 3 3 3 3 
3 3 3 3 31 27 3 3 31 3 3 3 3 31 31 31 3 3 3 3 
3 3 3 27 31 3 3 3 31 27 27 23 27 27 27 27 27 3 3 3 
3 3 3 27 31 3 3 27 31 23 23 23 23 3 3 3 27 3 3 3 
3 3 3 27 31 3 3 27 31 23 3 3 3 31 31 31 3 27 3 3 
3 3 3 27 31 23 27 27 27 27 3 27 3 31 23 31 3 27 3 3 
3 3 3 27 27 31 27 27 31 3 3 31 31 3 27 27 27 27 3 3 
3 3 3 23 23 31 27 3 31 3 31 31 3 3 23 27 27 3 3 3 
3 3 3 23 3 3 31 3 31 23 31 3 3 3 23 3 27 3 3 3 
3 3 3 3 3 3 31 27 3 31 23 23 23 23 3 3 27 3 3 3 
3 3 3 3 3 3 3 27 27 3 3 3 3 3 3 27 3 3 3 3 
3 3 3 3 3 3 3 3 27 27 27 27 27 27 27 3 3 3 3 3 
3 3 3 3 3 3 3 3 3 3 3 3 3 3 3 3 3 3 3 3 
3 3 3 3 3 3 3 3 3 3 3 3 3 3 3 3 3 3 3 3 
3 3 3 3 3 3 3 3 3 3 3 3 3 3 3 3 3 3 3 3 
3 3 3 3 3 3 3 3 3 3 3 3 3 3 3 3 3 3 3 3 

Player Spawn
10
8

Enemy Spawns
15
2
15
3
16
4
17
4
17
3
17
2
16
2
15
4
16
3

Enemy Count
200

