Size
20
10

Grid
33 33 33 33 33 33 33 33 33 33 33 33 33 33 33 33 33 33 33 33 
33 25 25 25 25 33 33 33 29 25 25 25 25 25 25 25 25 25 25 33 
33 25 25 25 25 33 33 33 25 25 25 25 25 25 25 25 25 33 25 33 
33 25 25 25 25 33 33 33 25 28 28 25 33 33 33 33 25 33 25 33 
33 25 25 25 25 25 25 25 25 28 28 25 33 33 33 33 25 25 25 33 
33 25 25 25 25 25 25 25 25 28 28 25 33 33 33 33 25 25 25 33 
33 25 25 25 25 33 33 33 25 28 28 25 33 33 33 33 25 33 25 33 
33 25 25 25 29 33 33 33 25 25 25 25 25 25 25 25 25 33 25 33 
33 25 25 25 25 33 33 33 25 25 25 25 25 25 25 25 25 25 25 33 
33 33 33 33 33 33 33 33 33 33 33 33 33 33 33 33 33 33 33 33 

Player Spawn
1
4

Enemy Spawns
18
1
18
2
18
3
18
4
18
5
17
5
16
5
16
4
16
3
16
2
16
1
17
1
17
4
18
6
18
7
18
8
17
8
16
8
16
7
16
6
15
1
15
2
14
2
13
2
13
1
14
1
13
7
14
7
15
7
15
8
14
8
13
8

Enemy Count
50

