Size
30
30

Grid
33 33 33 33 33 33 33 33 33 33 33 33 33 33 33 33 33 33 33 33 33 33 28 28 28 28 28 28 28 28 
33 33 5 33 33 33 33 33 33 33 33 33 33 33 33 33 33 33 33 33 28 28 29 29 29 29 29 29 29 28 
33 33 3 3 3 18 5 3 3 3 18 3 3 3 18 3 6 7 33 28 28 29 29 25 25 29 29 29 29 28 
33 33 3 3 3 13 3 3 3 3 13 4 4 4 13 3 3 3 33 28 29 29 25 25 25 29 29 25 29 28 
33 33 22 20 21 13 20 4 4 22 13 20 22 21 13 4 4 22 33 28 29 25 25 25 25 25 26 26 29 28 
33 33 15 14 14 8 14 14 14 14 8 14 14 14 8 14 14 14 14 14 16 25 25 25 25 25 27 27 29 28 
33 33 22 4 4 13 20 21 22 4 13 21 4 4 13 4 22 22 33 28 29 25 25 3 25 25 25 25 29 28 
33 33 4 4 20 13 4 4 4 4 13 4 33 4 13 4 4 4 33 28 29 25 25 25 25 3 25 25 29 28 
33 33 4 4 4 13 4 4 22 20 13 22 4 21 13 20 21 20 33 28 29 25 25 25 25 25 25 25 29 28 
33 33 15 14 14 8 14 14 14 14 8 14 14 14 8 14 14 16 33 28 29 29 29 29 3 29 29 29 29 28 
33 33 22 20 4 13 20 4 21 4 13 4 20 22 13 22 22 4 33 28 28 28 28 23 3 23 28 28 28 28 
33 33 4 4 4 13 4 4 4 22 13 4 4 4 13 4 4 4 33 33 33 33 5 23 3 23 5 33 33 33 
33 33 4 4 21 13 4 4 4 22 13 4 4 4 13 22 4 4 33 33 33 33 5 31 3 31 6 7 33 33 
33 33 4 4 20 17 4 4 4 4 17 4 4 4 17 4 4 4 33 33 33 33 5 31 3 31 5 33 33 33 
33 33 33 33 33 33 33 33 33 33 33 33 33 33 33 33 33 33 33 33 33 6 7 31 3 31 5 33 33 33 
33 33 33 33 33 33 33 33 33 33 33 33 33 33 33 33 33 33 33 33 33 33 5 31 3 31 5 33 33 33 
33 33 33 33 33 33 33 33 33 33 33 33 33 33 33 33 33 33 33 33 33 33 5 31 3 31 5 33 33 33 
33 33 33 33 33 33 33 33 33 33 33 33 33 33 33 19 19 19 19 19 19 19 19 19 3 19 19 19 19 33 
28 28 28 28 28 28 28 28 28 28 28 28 33 33 33 19 19 19 19 19 19 19 19 30 3 19 19 19 19 33 
28 28 28 28 28 28 28 28 28 28 28 28 33 33 33 19 19 19 31 31 3 3 3 3 3 3 32 19 19 33 
33 3 20 4 4 4 21 22 4 4 28 28 33 33 33 19 19 19 3 32 32 3 3 3 3 31 32 19 19 33 
33 3 4 4 4 4 4 4 4 4 28 28 28 28 28 19 19 19 3 32 32 32 3 3 3 3 32 19 19 33 
33 3 4 4 24 4 4 4 4 4 28 28 27 27 27 19 19 19 3 3 32 32 3 3 30 3 32 19 19 33 
33 3 4 4 4 15 14 14 14 14 14 14 14 14 14 14 14 14 14 14 14 16 3 32 32 32 32 19 19 33 
33 3 4 22 4 4 4 4 4 4 28 28 27 27 27 3 3 3 3 3 31 3 3 32 32 31 32 19 19 33 
33 3 4 4 4 21 24 4 4 4 28 28 28 28 28 19 19 19 3 3 3 3 3 3 3 3 3 19 19 33 
33 3 4 4 4 4 4 4 4 4 28 28 28 28 28 19 19 19 19 19 19 19 19 19 19 19 19 19 19 33 
33 3 4 4 4 4 4 24 4 20 28 28 33 33 33 19 19 19 19 19 19 19 19 19 19 19 19 19 19 33 
33 3 3 3 3 3 3 3 3 3 28 28 33 33 33 33 33 33 33 33 33 33 33 33 33 33 33 33 33 33 
33 34 33 33 33 33 33 33 33 33 28 28 33 33 33 33 33 33 33 33 33 33 33 33 33 33 33 33 33 33 

Player Spawn
2
27

Enemy Spawns
23
2
24
2
22
3
23
3
24
3
21
4
27
8
27
7
2
2
3
2
4
2
4
3
3
3
2
3
2
5
3
5
3
6
3
7
2
7
2
8
3
8
3
9
2
9
2
11
2
12
2
13
9
2
10
2
11
2
12
2
10
13
11
13
12
13
14
9
15
9
13
9
14
8
14
10
25
19
26
25
25
25
24
25
23
25
25
22
25
21
24
21
20
19
21
19
18
20
18
25
19
25

Enemy Count
100

