Size
20
20

Grid
33 33 33 33 33 33 33 33 33 33 33 33 33 33 33 33 33 33 33 33 
33 33 33 33 33 33 33 33 33 33 33 33 3 3 3 5 33 33 33 33 
33 33 33 33 33 33 33 33 33 33 3 3 3 24 27 3 3 33 33 33 
33 33 33 33 33 33 33 33 33 19 3 24 4 4 4 4 24 24 33 33 
33 33 33 33 33 33 33 33 33 19 4 4 4 4 4 4 4 3 3 33 
33 33 33 34 33 33 5 19 19 19 4 4 4 4 4 4 4 24 3 33 
33 33 33 33 33 5 5 19 19 4 4 4 4 4 4 4 4 4 5 33 
33 33 33 33 5 5 4 3 3 4 4 4 4 4 4 4 4 3 3 33 
33 33 33 5 5 5 4 4 4 4 4 4 4 4 4 4 4 3 3 33 
33 33 33 3 4 4 4 24 4 4 4 4 4 4 4 4 4 3 33 33 
33 33 3 3 4 24 4 4 4 4 4 4 4 4 24 24 24 3 3 33 
33 33 3 3 4 4 4 4 4 4 4 4 24 24 24 24 3 3 33 33 
33 3 3 3 24 3 20 20 4 4 4 3 3 3 3 3 33 33 33 33 
33 3 3 3 3 24 4 4 33 33 4 3 33 33 33 33 33 33 33 33 
33 3 3 3 24 3 4 4 33 33 4 24 3 33 3 3 3 3 33 33 
33 33 3 3 3 3 3 4 4 4 4 24 3 33 3 4 4 3 33 33 
33 33 33 3 3 3 3 3 21 21 21 24 3 33 3 3 3 3 33 33 
33 33 33 3 3 3 3 3 3 3 3 3 33 33 33 3 3 33 33 33 
33 33 33 33 33 33 3 33 3 3 3 33 33 33 33 33 33 33 33 33 
33 33 33 33 33 33 33 33 33 33 33 33 33 33 33 33 33 33 33 33 

Player Spawn
4
16

Enemy Spawns
12
3
13
3
14
3
15
3
15
4
16
4
14
4
13
4
13
5
14
5
15
5
16
5
16
6
17
6
15
6
14
6

Enemy Count
50

